opportunism: n. chủ nghĩa cơ hội
favorable a. thuận lợi
specialist: n. chuyên gia

recent = recently: gần đây - the most recent: gần đây nhất
late a. muộn  adv. chậm
lately : a. gần đây
Recently và Lately: đều có nghĩa là gần đây, chỉ những việc xảy ra gần đây, nhưng vẫn còn tiếp tục tiếp diễn. 
Recently có vẻ lâu hơn chút (tuần, tháng) còn lately ngắn hơn (ngày, tuần). Lately hay dùng trong văn nói.


exceed: v. vượt quá
quantitative: a. định lượng
discredit v. làm mấy uy tín
distress v.n  phiền muộn
delineate: /dɪˈlɪniˌeɪt/ v. phân định
write permission
in whole: toàn bộ

A fax was dated March 4: Một bản fax được đề ngày 4 tháng 3

accompaniment: vật phụ thuộc, hợp tấu
announcement: sự thông báo
detainment: sự giam giữ
arraign: /əˈreɪn/ buộc tội - arraignment

participate /pɑrˈtɪsəˌpeɪt/ v. = join

surpass v. vượt qua
surplus n. số dư
surprise n. ngạc nhiên v.làm kinh ngạc

beset: v. bao vây - Vbp beset
cease: v. ngưng, hết, thôi

policy: n.  chính sách
safety n. sự oan toàn

patron: n. người bảo hộ, khách hàng quen
to beware of pickpockets: cẩn thận những kẻ móc túi

avert: v. ngăn chặn
aler: v. cảnh báo
the mean time: thời gian trung bình

dispute n,v. tranh chấp
despair n,v. tuyệt vọng, đau lòng

sage. a. khôn n. quân tử

license: n giấy phép

lucrative: a. sinh lợi
conclude: kết luận
occupation: n. nghề nghiệp

chunk: gỗ, miếng phomat, bánh mỳ

nervous a. lo lắng

mortgage: v.n thế chấp, sự cho vay
exceptional: a. đặc biệt
deserve: v. xứng đáng
counselor: n. tư vấn viên

be repossessed: bị tịch thu


quadruple: n.a.v gấp 4 lần. khó rủ bồ đi chơi gấp 4 lần lúc mới quens
inquire: v. hỏi thăm
brochure sách, tạp chí nhỏ. b.rầu sơ

urge /ərdʒ/ n.v thúc giục, xô đẩy

ingestion: sự ăn vào. in dết chần

instructional manual: hướng dẫn sử dụng
instructional memo: thư báo hướng dẫn

appropriate: thích hợp

rental: n. tiền mướn, tiền thuê

closet n. tủ quần áo
adopt chấp nhận